WWWWWWWWWWWWWWW
WPWLWDWRWNWN.NW
WFWLWDWRWNWN.NW
WFWLWDWRWN.N.NW
WF.i.....ii...W
W....i...ndrflW
W.......i.i...W
W....i...ndrflW
WWWWWWWWWWWWWWW
