WWWWWWWWWWWWWWW
W....i.P......W
W......iWWWWWWW
W.............W
W....ii.d.....W
W.............W
W...W.W.W.W.W.W
W...WDWRWNWLWFW
WWWWWWWWWWWWWWW
