WWWWWWWWWWWWWWW
W......P......W
W.............W
W.............W
W.............W
W......WWWW...W
W......W......W
W......WD.....W
WWWWWWWWWWWWWWW
