WWWWWWW
W.....W
WWWWW.W
WW....W
W..WW.W
WP.WD.W
WWWWWWW